TILEMAP
24 24 			-- Size of tile map in tiles
16 32			-- Tile size & block size
images/tiles_cols.png 	--Tilesheet
1 8				-- Number of tiles in tilesheet
888888888888888888888888
800000000000000000000008
800000000000000000000008
800000000000000000000008
800088000000000000880008
800000880000000088000008
800000300000000000000008
800000000000000000000008
800000004040404000000008
800000004040404000000008
800000000000000000000008
800000888888888888000008
800088400000000040880008
808840400000000040408808
884040000000000000404088
804000000000000000004008
800000000000000000000008
800000000000000000000008
800000000000000000000008
800000000000000000000008
800000000000000000000008
800000000000000000000008
800000000000000000000008
888888880000000088888888