TILEMAP
24 24 			-- Size of tile map in tiles
16 32			-- Tile size & block size
images/tiles_cols.png 	--Tilesheet
1 8				-- Number of tiles in tilesheet
888888888888888888888888
800000000000000000000008
800000000000000000000008
800000000000000000000008
800000000000000000000008
800000001000001010000008
800000000000000000000008
800000101000102020100008
800000000000000000000008
800010001000100020100008
800000000000000000000008
800000001000102020100008
800000000000000000000008
800000001000102020100008
800000000000000000000008
800000001000001010000008
800000000000000000000008
800000005050505050000008
888888884040404040888888
800000000000000000000008
800000000000000000000008
800000006000600060000008
800000000000000000000008
888800000000000000008888