TILEMAP
24 24 			-- Size of tile map in tiles
16 32			-- Tile size & block size
images/tiles_cols.png 	--Tilesheet
1 8				-- Number of tiles in tilesheet
888888888888888888888888
800000000000000000000008
803020000000000000200008
800000000000000000000008
808888000000000000888808
800000000000000000000008
800000505050505050000008
800040000000000000400008
805000404040404040005008
800040000000000000400008
804000505050505050004008
800040000000000000400008
805000404040404040005008
800040000000000000400008
804000505050505050004008
800000000000000000000008
805000404040404040005008
800000000000000000000008
800000000000000000000008
800000000000000000000008
800000000000000000000008
800000000000000000000008
800000000000000000000008
888888800000000008888888