TILEMAP
24 24 			-- Size of tile map in tiles
16 32			-- Tile size & block size
images/tiles_cols.png 	--Tilesheet
1 8				-- Number of tiles in tilesheet
888888888888888888888888
888888000000000000888888
888800000010100000008888
880000000000000000000088
800040000020200000000008
800040000000000000000008
800040002020202000000008
800000000000000000000008
800000002010102000000008
800000000000000000000008
800000001010101000000008
800000000000000000000008
800000005088885000400008
800000000040400000000008
800000000000000000000008
880000000000000000000088
808800000000000000008808
800088000000000000880008
800000880050500088000008
800000000000000000000008
800000000000000000000008
800000000000000000000008
800000000000000000000008
888888800000000008888888