TILEMAP
24 24 			-- Size of tile map in tiles
16 16			-- Tile size & block size
images/tiles_cols.png 	--Tilesheet
2 16				-- Number of tiles in tilesheet
29 29 29 29 29 29 29 29 29 29 29 29 29 29 29 29 29 29 29 29 29 29 29 29 
29 0 0 0 0 0 0 0 0 0 0 0 0 0 0 0 0 0 0 0 0 0 0 29 
29 0 0 0 0 0 0 0 0 0 0 0 0 0 0 0 0 0 0 0 0 0 0 29 
29 0 0 0 0 0 0 0 0 0 0 0 0 0 0 0 0 0 0 0 0 0 0 29 
29 0 0 0 0 0 0 0 0 0 0 0 0 0 0 0 0 0 0 0 0 0 0 29 
29 0 0 0 0 0 0 0 0 0 0 0 0 0 0 0 0 0 0 0 0 0 0 29 
29 0 0 0 0 0 0 0 0 0 0 0 0 0 0 0 0 0 0 0 0 0 0 29 
29 0 0 0 0 0 0 0 0 0 0 0 0 0 0 0 0 0 0 0 0 0 0 29 
29 0 0 0 0 0 0 0 0 0 0 0 0 0 0 0 0 0 0 0 0 0 0 29 
29 0 0 0 29 29 0 0 0 0 0 0 0 0 0 0 0 0 29 0 0 0 0 29 
29 0 0 0 0 0 29 29 0 0 0 0 0 0 0 0 29 29 0 0 0 0 0 29 
29 0 0 0 0 0 9 10 0 0 0 0 0 0 0 0 0 0 0 0 0 0 0 29 
29 0 0 0 0 0 11 12 0 0 0 0 0 0 0 0 0 0 0 0 0 0 0 29 
29 0 0 0 0 0 0 0 13 14 13 14 13 14 13 14 0 0 0 0 0 0 0 29 
29 0 0 0 0 0 0 0 0 0 0 0 0 0 0 0 0 0 0 0 0 0 0 29 
29 0 0 0 0 0 29 29 0 0 0 0 0 0 0 0 29 29 0 0 0 0 0 29 
29 0 0 0 29 29 13 14 0 0 0 0 0 0 0 0 13 14 29 29 0 0 0 29 
29 0 29 29 13 14 13 14 0 0 0 0 0 0 0 0 13 14 13 14 29 29 0 29 
29 29 13 14 13 14 0 0 0 0 0 0 0 0 0 0 0 0 13 14 13 14 29 29 
29 0 13 14 0 0 0 0 0 0 0 0 0 0 0 0 0 0 0 0 13 14 0 29 
29 0 0 0 0 0 0 0 0 0 0 0 0 0 0 0 0 0 0 0 0 0 0 29 
29 0 0 0 0 0 0 0 0 0 0 0 0 0 0 0 0 0 0 0 0 0 0 29 
29 0 0 0 0 0 0 0 0 0 0 0 0 0 0 0 0 0 0 0 0 0 0 29 
29 29 29 29 29 29 29 29 0 0 0 0 0 0 0 0 29 29 29 29 29 29 29 29