TILEMAP
24 24 			-- Size of tile map in tiles
16 32			-- Tile size & block size
images/tiles_cols.png 	--Tilesheet
1 8				-- Number of tiles in tilesheet
888888888888888888888888
800000000000000000000008
800000004040404000000008
804040400000000040404008
801040000020200000401008
800040000000000000400008
888840404040404040408888
801040000010100000401008
800040400000000040400008
804040000088880000404008
801040400040400040401008
800040000020200000400008
888840404000004040408888
800040000000000000400008
800040000020200000400008
800040400000000040400008
800000000040400000000008
800000000000000000000008
800000000000000000000008
800000000000000000000008
800000000000000000000008
800000000000000000000008
800000000010000000000008
888888880000000088888888