TILEMAP
24 24 			-- Size of tile map in tiles
16 32			-- Tile size & block size
images/tiles_cols.png 	--Tilesheet
1 8				-- Number of tiles in tilesheet
888888888888888888888888
800000000000000000000008
800000000000000000000008
800000000000000000000008
800000000000000000000008
804040404040404040404008
800000000000000000000008
804000004000004000004008
800040400000000040400008
800040400040400040400008
804030400040400040404008
804000400040400040404008
800040400000000040400008
800040400000000040400008
800040400000000040400008
800000000000000000000008
800000000000000000000008
800000000000000000000008
800000000000000000000008
800000000000000000000008
800000000000000000000008
800000000000000000000008
800000000000000000000008
888888880000000088888888