TILEMAP
24 24 			-- Size of tile map in tiles
16 32			-- Tile size & block size
images/tiles_cols.png 	--Tilesheet
1 8				-- Number of tiles in tilesheet
888888888888888888888888
800000000000000000000008
800000000000000000000008
800000000000000000000008
800040404000004040400008
800040004000004000400008
804000000060600000004008
884000000000000000004088
884000000000000000004088
804000000060600000004008
804040004000004000404008
800040404000004040400008
800000000000000000000008
800000000003000000000008
800000000000000000000008
805050000088880000505008
800060505050505050600008
800000501010101050000008
800000600000000060000008
800000005050505000000008
800000000050500000000008
800000000000000000000008
800000000000000000000008
888800000000000000008888