TILEMAP
24 24 			-- Size of tile map in tiles
16 32			-- Tile size & block size
images/tiles_cols.png 	--Tilesheet
1 8				-- Number of tiles in tilesheet
888888888888888888888888
800000000000000000000008
800000000000000000000008
800000000000000000000008
800088880000000088880008
804030005000004000004008
805000000000005000005008
804000000000004000004008
808800000000008800008808
804000888800004000004008
805000005000005000005008
804000004000004000004008
800088880000000088880008
800000000000000000000008
804000000000000000004008
804040404040404040404008
800040404040404040400008
800000004000000040000008
800000000000000000000008
800000000000000000000008
800000000000000000000008
800000000000000000000008
800000000000000000000008
888888800000000008888888