TILEMAP
24 24 			-- Size of tile map in tiles
16 32			-- Tile size & block size
images/tiles_cols.png 	--Tilesheet
1 8				-- Number of tiles in tilesheet
888888888888888888888888
800000000000000000000008
800000000000000000000008
800000000000000000000008
800000000000000000000008
804000004005060000005008
805000005004050000004008
804000004005006000005008
805000005004005000004008
804000004005000603005008
805000005004000500004008
804000004005000060005008
805000005004000050004008
804000004005000006005008
805020205004000005004008
804000004005000000605008
800060600004000000504008
800000000000000000000008
800000000000000000000008
800000000000000000000008
800000000000000000000008
800000000000000000000008
800000000000000000000008
888800000000000000008888