TILEMAP
24 72 			-- Size of tile map in tiles
32 32			-- Tile size & block size
images/wood.png 	--Tilesheet
1 1				-- Number of tiles in tilesheet
1 1 1 1 1 1 1 1 1 1 1 1 1 1 1 1 1 1 1 1 1 1 1 1 
1 0 0 0 0 0 0 0 0 0 0 0 0 0 0 0 0 0 0 0 0 0 0 1 
1 0 0 0 0 0 0 0 0 0 0 0 0 0 0 0 0 0 0 0 0 0 0 1 
1 0 0 0 0 0 0 9 0 0 0 0 0 9 0 9 0 0 0 0 0 0 0 1 
1 0 0 0 0 0 0 0 0 0 0 0 0 0 0 0 0 0 0 0 0 0 0 1 
1 0 0 0 0 9 0 9 0 0 0 9 0 8 0 8 0 9 0 0 0 0 0 1 
1 0 0 0 0 0 0 0 0 0 0 0 0 0 0 0 0 0 0 0 0 0 0 1 
1 0 0 9 0 0 0 9 0 0 0 9 0 10 0 8 0 9 0 0 0 0 0 1 
1 0 0 0 0 0 0 0 0 0 0 0 0 0 0 0 0 0 0 0 0 0 0 1 
1 0 0 0 0 0 0 9 0 0 0 9 0 8 0 8 0 9 0 0 0 0 0 1 
1 0 0 0 0 0 0 0 0 0 0 0 0 0 0 0 0 0 0 0 0 0 0 1 
1 0 0 0 0 0 0 9 0 0 0 9 0 8 0 8 0 9 0 0 0 0 0 1 
1 0 0 0 0 0 0 0 0 0 0 0 0 0 0 0 0 0 0 0 0 0 0 1 
1 0 0 0 0 0 0 9 0 0 0 0 0 9 0 9 0 0 0 0 0 0 0 1 
1 0 0 0 0 0 0 0 0 0 0 0 0 0 0 0 0 0 0 0 0 0 0 1 
1 0 0 0 0 0 0 4 0 4 0 4 0 4 0 4 0 0 0 0 0 0 0 1 
1 1 1 1 1 1 1 3 0 3 0 3 0 3 0 3 0 1 1 1 1 1 1 1 
1 0 0 0 0 0 0 0 0 0 0 0 0 0 0 0 0 0 0 0 0 0 0 1 
1 0 0 0 0 0 0 0 0 0 0 0 0 0 0 0 0 0 0 0 0 0 0 1 
1 0 0 0 0 0 0 5 0 0 0 5 0 0 0 5 0 0 0 0 0 0 0 1 
1 0 0 0 0 0 0 0 0 0 0 0 0 0 0 0 0 0 0 0 0 0 0 1 
1 0 0 0 0 0 0 0 0 0 0 0 0 0 0 0 0 0 0 0 0 0 0 1 
1 0 0 0 0 0 0 0 0 0 0 0 0 0 0 0 0 0 0 0 0 0 0 1 
1 0 0 0 0 0 0 0 0 0 0 0 0 0 0 0 0 0 0 0 0 0 0 1 
1 1 1 1 1 1 1 1 1 1 2 2 2 2 1 1 1 1 1 1 1 1 1 1 
1 0 0 0 0 0 0 0 0 0 0 0 0 0 0 0 0 0 0 0 0 0 0 1 
1 0 0 0 0 0 0 0 0 0 0 0 0 0 0 0 0 0 0 0 0 0 0 1 
1 0 0 0 0 0 0 0 0 0 0 0 0 0 0 0 0 0 0 0 0 0 0 1 
1 0 0 0 0 0 0 0 0 0 0 0 0 0 0 0 0 0 0 0 0 0 0 1 
1 0 3 0 0 0 0 0 3 0 0 4 0 5 0 0 0 0 0 0 4 0 0 1 
1 0 4 0 0 0 0 0 4 0 0 3 0 4 0 0 0 0 0 0 3 0 0 1 
1 0 3 0 0 0 0 0 3 0 0 4 0 0 0 5 0 0 0 0 4 0 0 1 
1 0 4 0 0 0 0 0 4 0 0 3 0 0 0 4 0 0 0 0 3 0 0 1 
1 0 3 0 0 0 0 0 3 0 0 4 0 0 0 5 0 11 0 0 4 0 0 1 
1 0 4 0 9 0 9 0 4 0 0 3 0 0 0 4 0 0 0 0 3 0 0 1 
1 0 3 0 0 0 0 0 3 0 0 4 0 0 0 0 0 5 0 0 4 0 0 1 
1 0 4 0 8 0 8 0 4 0 0 3 0 0 0 0 0 4 0 0 3 0 0 1 
1 0 3 0 0 0 0 0 3 0 0 4 0 0 0 0 0 5 0 0 4 0 0 1 
1 0 4 0 9 0 9 0 4 0 0 3 0 0 0 0 0 4 0 0 3 0 0 1 
1 0 3 0 0 0 0 0 3 0 0 4 0 0 0 0 0 0 5 0 4 0 0 1 
1 0 0 0 5 0 5 0 0 0 0 3 0 0 0 0 0 0 4 0 3 0 0 1 
1 0 0 0 0 0 0 0 0 0 0 0 0 0 0 0 0 0 0 0 0 0 0 1 
1 0 0 0 0 0 0 0 0 0 0 0 0 0 0 0 0 0 0 0 0 0 0 1 
1 0 0 0 0 0 0 0 0 0 0 0 0 0 0 0 0 0 0 0 0 0 0 1 
1 0 0 0 0 0 0 0 0 0 0 0 0 0 0 0 0 0 0 0 0 0 0 1 
1 0 0 0 0 0 0 0 0 0 0 0 0 0 0 0 0 0 0 0 0 0 0 1 
1 0 0 0 0 0 0 0 0 0 0 0 0 0 0 0 0 0 0 0 0 0 0 1 
1 1 1 1 0 0 0 0 0 0 0 0 0 0 0 0 0 0 0 0 1 1 1 1 
1 1 1 1 1 1 1 1 1 1 2 2 2 2 1 1 1 1 1 1 1 1 1 1 
1 0 0 0 0 0 0 0 0 0 0 0 0 0 0 0 0 0 0 0 0 0 0 1 
1 0 0 0 3 0 3 0 3 0 0 0 0 0 3 0 3 0 3 0 0 0 0 1 
1 0 3 0 3 0 0 0 3 0 0 0 0 0 3 0 0 0 3 0 3 0 0 1 
1 1 3 0 0 0 0 0 0 0 5 0 5 0 0 0 0 0 0 0 3 0 1 1 
1 1 3 0 0 0 10 0 0 0 0 0 0 0 0 0 9 0 0 0 3 0 1 1 
1 0 3 0 0 0 0 0 0 0 5 0 5 0 0 0 0 0 0 0 3 0 0 1 
1 0 3 0 3 0 0 0 3 0 0 0 0 0 3 0 0 0 3 0 3 0 0 1 
1 0 0 0 3 0 3 0 3 0 0 0 0 0 3 0 3 0 3 0 0 0 0 1 
1 0 0 0 0 0 0 0 0 0 0 11 0 0 0 0 0 0 0 0 0 0 0 1 
1 0 0 0 0 0 0 0 0 0 0 0 0 0 0 0 0 0 0 0 0 0 0 1 
1 0 4 0 4 0 0 0 0 0 1 1 1 1 0 0 0 0 4 0 4 0 0 1 
1 0 0 0 5 0 4 0 4 0 4 0 4 0 4 0 4 0 5 0 0 0 0 1 
1 0 0 0 0 0 4 0 8 0 8 0 8 0 8 0 4 0 0 0 0 0 0 1 
1 0 0 0 0 0 5 0 0 0 0 0 0 0 0 0 5 0 0 0 0 0 0 1 
1 0 0 0 0 0 0 0 4 0 4 0 4 0 4 0 0 0 0 0 0 0 0 1 
1 0 0 0 0 0 0 0 0 0 4 0 4 0 0 0 0 0 0 0 0 0 0 1 
1 0 0 0 0 0 0 0 0 0 0 0 0 0 0 0 0 0 0 0 0 0 0 1 
1 0 0 0 0 0 0 0 0 0 0 0 0 0 0 0 0 0 0 0 0 0 0 1 
1 0 0 0 0 0 0 0 0 0 0 0 0 0 0 0 0 0 0 0 0 0 0 1 
1 0 0 0 0 0 0 0 0 0 0 0 0 0 0 0 0 0 0 0 0 0 0 1 
1 0 0 0 0 0 0 0 0 0 0 0 0 0 0 0 0 0 0 0 0 0 0 1 
1 0 0 0 0 0 0 0 0 0 0 0 0 0 0 0 0 0 0 0 0 0 0 1 
1 1 1 1 0 0 0 0 0 0 0 1 1 0 0 0 0 0 0 0 1 1 1 1